
################################################
#..............................................#
#...???????????????..........???????????????...#
#...???????????????..........???????????????...#
#...???????????????..........???????????????...#
#...???????????????..........???????????????...#
#...???????????????..........???????????????...#
#..............................................#
#..............................................#
#..............................................#
#....................@@@@@@@...................#
#............@@@@@@@@@@@@@@@@@@@@@@............#
#............@@@@@@@@@@@@@@@@@@@@@@............#
#............@@@@@@@@@@@@@@@@@@@@@@............#
#............@@@@@@@@@@@@@@@@@@@@@@............#
#............@@@@@@@@@@@@@@@@@@@@@@............#
#............@@@@@@@@@@@@@@@@@@@@@@............#
#..............................................#
################################################